2
111111111111111111111111111111111111111111111111111111111111111111111111111111
1                        11                        11                        1
1                        11                        11                        1
1        22              11        33333333        11        44              1
1        22              11        33333333        11        44              1
1        22              11        33    33        11        44              1
1        22              11        33    33        11        44              1
1        22              11        33    33        11        44              1
1        22              11        33    33        11        44              1
1        22              11        33    33        11        44              1
1        22              11        33    33        11        44              1
1        22              11        33    33        11        44              1
1        222222          11        33333333        11        444444          1
1        222222          11        33333333        11        444444          1
1                        11                        11                        1
1                        11                        11                        1
111111111111111111111111111111111111111111111111111111111111111111111111111111
