2
11                                             3
1                         1                    3                                                             1                         11                         1                   1
1                                              3                         11                         1                                                                                 1
1                                              3                         11                         1                                                                                 1
1                                              3                         11                         1                                                                                 1
1                                              1                         11                         1                                                                                 1
1                                              1                         11                         1                                                                                 1
1                                              1                         11                         1                                                                                 1
1                                              1                         11                         1                                                                                 1
1                                              3                         11                         1                                                                                 1
1                                              31                         11                         1                                                                                 1
1                                              3                        11                         1                                                                                 1
1                                              3                         11                         1                                                                                 1
1                                              3                      11                         1                                                                                 1

                                  1                         11                         1                                                                                 1
111111111111111111111111111111111111111111111111111111111111111111111111111111111111111111111111111111111111111111111111111111111111111111111111111111111111111111111111111111111111111111111111111111111111111111111111111111111111111111
