2
                                       3             3                                         3                                      3                  3           3       4
                                       3              3                                                                                3                                     4
                                       3               3                                                  3       3          3                   3                           4
                                       3                3                              3                                                                          3          4
                        3             33                 3                                                                  3                             3                  4
                       3             3 3                  3                                     3                                       3                                    4
                      3             3  3                  11                                                                 3                                               4
                     3             3   3                 1  1                       3                    3      3                                    3                       4
                    3             3    3                  11                                                                                                                 4
                   3             3     3                 3                                                                3                                                  4
                  3             3      3                3                                                                                                                    4
                 3             3       3               3                                             3                                3                         3            4
                3             3333333333              3                                  3                                 3                     3                           4
               3                                     3                                                                                                                       4
              3                                     3                                         3                 3                            3              3         3      4
             3                                     3                                                                                        3                                4
111111111111111111111111111111111111111111111111111111111111111111111111111111111111111111111111111111111111111111111111111111111111111111111111111111111111111111111111111111
3 3 3 3 3 3 3 3 3 3 3 3 3 3 3 3 3 3 3 3 3 3 3 3 3 3 3 3 3 3 3 3 3 3 3 3 3 3 3 3 3 3 3 3 3 3 3 3 3 3 3 3 3 3 3 3 3 3 3 3 3 3 3 3 3 3 3 3 3 3 3 3 3 3 3 3 3 3 3 3 3 3 3 3 3 3 3 
