2
                                                               3                                                                                                             4
                                     3                         3                                                                                                             4
                                                               3                                           3                                                                 4
                                                               3                                          3                                          3                       4
                                                               3                                         3                                             3                     4
3                                                                                                       3                                                3                   4
 3                                         3                                                           3                                                   3                 4
  3                                                                                 3                 3                        3                             3               4
   3                                                                                3                                         3                                              4
    3                                                                               3                                        3                                               4
     3                     3                          3                             3                                       3                                                4
      3                    3                          3                             3                                      3                                                 4
       3                   3                          3                                                                                                                      4
                                                                                                                                                                             4
                                                                                                                                                                             4
                                                                                                                                                                             4
111111111111111111111111111111111111111111111111111111111111111111111111111111111111111111111111111111111111111111111111111111111111111111111111111111111111111111111111111111
3 3 3 3 3 3 3 3 3 3 3 3 3 3 3 3 3 3 3 3 3 3 3 3 3 3 3 3 3 3 3 3 3 3 3 3 3 3 3 3 3 3 3 3 3 3 3 3 3 3 3 3 3 3 3 3 3 3 3 3 3 3 3 3 3 3 3 3 3 3 3 3 3 3 3 3 3 3 3 3 3 3 3 3 3 3 3
